软体 ruǎntǐ - software/soft
柔韧 róurèn - flexible 
柔韧性 róurèn xìng - flexibility, 性	-ity, -ness
驱动 qūdòng - drive
特殊 tèshū - special
智能 zhìnéng - intelligent
材料 cáiliào - material
核心部件 Héxīn bùjiàn - core components
传感 Chuán gǎn - sensing
组成 Zǔchéng - composition, component, part, element
其实 Qíshí - in fact
硬度 Yìngdù - hardness
级 Jí - level
承受 Chéngshòu - bear, endure, support
压强 Yāqiáng - pressure
相对应 Xiāng duìyìng - Corresponding
称之 Chēng zhī - Call it
小于 Xiǎoyú - less than
定义 Dìngyì - definition
肌腱 Jījiàn - tendon
略微 Lüèwēi - Slightly
目前 Mùqián - Currently
所能见 Suǒ néng jiàn - Can see
硅橡胶 Guī xiàngjiāo - Silicone Rubber
常见 Chángjiàn - common
数值 Shùzhí - value
这与 Zhè yǔ - this with
材质 Cáizhì - materials
相近 Xiāngjìn - similar
联想到 Liánxiǎng dào - Think of
传统的 Chuántǒng de - traditional
刚性 Gāngxìng - rigidity
差别 Chābié - difference
体现 Tǐxiàn - reflect
结构 Jiégòu - structure
